abnormal end	异常终止     /æbˈnɔːml end/
abstract data type	抽象数据类型     /ˈæbstrækt ˈdeɪtə taɪp/
acceleration card	加速卡     /əkˌseləˈreɪʃn kɑːd/
access control	访问控制     /ˈækses kənˈtrəʊl/
access list	访问控制表     /ˈækses lɪst/
access permission	访问权限     /ˈækses pəˈmɪʃn/
access time	存取\(访问\)时间     /ˈækses taɪm/
accessibility	易接近的，可到达的     /əkˌsɛsɪˈbɪlɪti/
accessory program	附件程序     
account	账号     /əˈkaʊnt/
accounting software	会计软件     /əˈkaʊntɪŋ ˈsɒftweə\(r\)/
acoustic	声音的     /əˈkuːstɪk/
acronym	缩略词     /ˈækrənɪm/
active desktop	动态桌面     /ˈæktɪv ˈdesktɒp/
active window	激活窗口     /ˈæktɪv ˈwɪndəʊ/
acyclic directory structure	非循环目录结构     
adapter card	适配卡     /əˈdæptə kɑːd/
adaptive scheduler	自适应调度     
address space	地址空间     /əˈdres speɪs/
addressing mechanism	寻址机制     /əˈdresɪŋ ˈmekənɪzəm/
administrator	管理员     /ədˈmɪnɪstreɪtə\(r\)/
algorithm	算法     /ˈælɡərɪðəm/
alignment	队列     /əˈlaɪnmənt/
alphabetic	依字母顺序的     /ˌælfəˈbetɪk/
alphanumeric	字母数字的     /ˌælfənjuːˈmerɪk/
amplify	放大     /ˈæmplɪfaɪ/
animation	动画     /ˌænɪˈmeɪʃn/
anti\-virus program	防病毒程序     /ˈænti ˈvaɪrəs ˈprəʊɡræm/
application integration	应用程序集成     /ˌæplɪˈkeɪʃn ˌɪntɪˈɡreɪʃn/
application layer	应用层     /ˌæplɪˈkeɪʃn ˈleɪə\(r\)/
application object	应用对象     /ˌæplɪˈkeɪʃn ˈɒbdʒɪkt/
archiving	存档     /ˈɑːkaɪvɪŋ/
arrow key	箭头键，方向键     /ˈærəʊ kiː/
artificial intelligence	人工智能     /ˌɑːtɪfɪʃl ɪnˈtelɪdʒəns/
assembler	汇编程序     /əˈsemblə\(r\)/
assessment	评估     /əˈsesmənt/
assignment	分配     /əˈsaɪnmənt/
assortment	分类     /əˈsɔːtmənt/
asymmetric encryption	非对称加密     /ˌeɪsɪˈmetrɪk ɪnˈkrɪpʃ\(ə\)n/
asynchronous	异步的     /eɪˈsɪŋkrənəs/
asynchronous primitive	异步原语     
atomic action	原子操作     /əˈtɒmɪk ˈækʃn/
atomicity property	原子属性     
attachment	附件     /əˈtætʃmənt/
attribute	属性，标志     /əˈtrɪbjuːt/
auction online	在线拍卖     /ˈɔːkʃn ˌɒnˈlaɪn/
audience demographic	受众人数统计     
authentication	身份验证     /ɔːˌθentɪˈkeɪʃn/
authorization	授权，认可     /ˌɔːθəraɪˈzeɪʃn/
automation server	自动化服务器     /ˌɔːtəˈmeɪʃn ˈsɜːvə\(r\)/
auxiliary	辅助的     /ɔːɡˈzɪliəri/
background	后台，背景     /ˈbækɡraʊnd/
bandwidth	带宽     /ˈbændwɪdθ/
banner	横幅     /ˈbænə\(r\)/
bar code	条形码     /bɑː\(r\) kəʊd/
base\-band	基带     /beɪs bænd/
batch processing	批处理     /ˌbætʃ ˈprəʊsesɪŋ/
baud	波特     /bɔːd/
baud rate	波特率     /bɔːd reɪt/
bibliography	参考文献     /ˌbɪbliˈɒɡrəfi/
big data	大数据     /ˌbɪɡ ˈdeɪtə/
binary digit	二进制数字     /ˈbaɪnəri ˈdɪdʒɪt/
bind	绑定     /baɪnd/
biometrics	生物统计学     /ˌbaɪəʊˈmɛtrɪks/
biometrics device	生物特征辨识装置     
bitable	双稳态的     
bitmap	位图     /ˈbɪtmæp/
black box	黑匣子     /ˌblæk ˈbɒks/
block diagram	框图     /ˈblɒk daɪəɡræm/
block structure	模块化结构     /blɒk ˈstrʌktʃə\(r\)/
boolean logic	布尔逻辑     /ˈbuːliən ˈlɒdʒɪk/
boot block	引导块，启动块     /buːt blɒk/
boot sector	引导扇区     /buːt ˈsektə\(r\)/
boot strap	引导程序     /buːt stræp/
boot up	启动     /buːt ʌp/
boundary	界限，边界     /ˈbaʊndri/
branch	分支     /brɑːntʃ/
broadband network	宽带网络     /ˈbrɔːdbænd ˈnetwɜːk/
broadcast address	广播地址     /ˈbrɔːdkɑːst əˈdres/
broadcast storm	广播风暴     /ˈbrɔːdkɑːst stɔːm/
browser	浏览器     /ˈbraʊzə\(r\)/
bubble jet printer	喷墨打印机     /ˈbʌbl dʒet ˈprɪntə\(r\)/
built\-in	内置的，嵌入式的     /ˌbɪlt ˈɪn/
bulk storage	大容量存储器     /bʌlk ˈstɔːrɪdʒ/
bulletin board	公告板     /ˈbʊlətɪn bɔːd/
bus\-contention	总线争用     
calibration	校准     /ˌkælɪˈbreɪʃn/
carriage return	回车     /ˈkærɪdʒ rɪˈtɜːn/
carrier	载体     /ˈkæriə\(r\)/
cartography	绘图法     /kɑːˈtɒɡrəfi/
certificate authority	证书认证，认证机构     /səˈtɪfɪkət ɔːˈθɒrəti/
chain reaction	链式反应     /ˌtʃeɪn riˈækʃn/
channel	信道     /ˈtʃænl/
chassis	机箱     /ˈʃæsi/
check box	复选框     /tʃek bɒks/
child node	子节点     /tʃaɪld nəʊd/
child window	子窗口     /tʃaɪld ˈwɪndəʊ/
chipset	芯片组     
cipher text	密文     /ˈsaɪfə\(r\) tekst/
circuit switching	电路交换     /ˈsɜːkɪt ˈswɪtʃɪŋ/
classification	分级，分类     /ˌklæsɪfɪˈkeɪʃn/
client program	客户端程序     /ˈklaɪənt ˈprəʊɡræm/
client server	客户机服务器     /ˌklaɪənt ˈsɜːvə\(r\)/
clipboard	剪贴板     /ˈklɪpbɔːd/
cloud computing	云计算     /ˈklaʊd kəmpjuːtɪŋ/
coaxial cable	同轴电缆     /ˈkəʊˈæksɪəl ˈkeɪbl/
coding	编码     /ˈkəʊdɪŋ/
cognitive	认知的，认识的     /ˈkɒɡnətɪv/
coherent	一致的，连贯的     /kəʊˈhɪərənt/
collaborative	合作的，协作的     /kəˈlæbərətɪv/
command button	命令按钮     /kəˈmɑːnd ˈbʌtn/
comment	注释，评论     /ˈkɒment/
communication deadlock	通信死锁     /kəˌmjuːnɪˈkeɪʃn ˈdedlɒk/
compatibility	兼容性     /kəmˌpætəˈbɪləti/
compiler	编译程序，编译器     /kəmˈpaɪlə\(r\)/
compression	压缩分布式处理     /kəmˈprɛʃən/
computability	可计算性     
computerize	计算机化     /kəmˈpjuːtəraɪz/
concurrent	并发的     /kənˈkʌrənt/
confidential	机密的     /ˌkɒnfɪˈdenʃl/
configuration	配置     /kənˌfɪɡəˈreɪʃn/
conflict	冲突     /ˈkɒnflɪkt/
congestion	拥塞     /kənˈdʒestʃən/
connectionless service	无连接服务     /kəˈnɛkʃənləs ˈsɜːvɪs/
connection\-oriented service	面向连接的服务     /kəˈnekʃn ˈɔːrientɪd ˈsɜːvɪs/
constraint	约束     /kənˈstreɪnt/
construct	构造     /kənˈstrʌkt/
container	容器     /kənˈteɪnə\(r\)/
context	上下文     /ˈkɒntekst/
control box	控制箱     /kənˈtrəʊl bɒks/
control panel	控制面板     /kənˈtrəʊl ˈpænl/
cooling fan	冷却风扇     /ˈkuːlɪŋ fæn/
coordinate	协调，坐标     /kəʊˈɔːdɪneɪt/
cordless mouse	无线鼠标     /ˈkɔːdləs maʊs/
core	磁芯     /kɔː\(r\)/
correlation	相关性     /ˌkɒrəˈleɪʃn/
cracker	解密者     /ˈkrækə\(r\)/
criteria	标准     /kraɪ'tɪəriə/
critical region	临界区     /ˈkrɪtɪkl ˈriːdʒən/
cross platform	跨平台的     /ˌkrɒs ˈplætfɔːm/
cryptography	密码学     /krɪpˈtɒɡrəfi/
cybercash	电子货币     
cybercrime	网络犯罪     
cyberspace	网络空间     /ˈsaɪbəspeɪs/
data flow diagram	数据流程图     /ˈdeɪtə fləʊ ˈdaɪəɡræm/
data link layer	数据链路层     /ˈdeɪtə lɪŋk ˈleɪə\(r\)/
data mining	数据挖掘     /ˈdeɪtə maɪnɪŋ/
data model	数据模型     /ˈdeɪtə ˈmɒdl/
data source	数据源     /ˈdeɪtə sɔːs/
data stream	数据流     /ˈdeɪtə striːm/
data structure	数据结构     /ˈdeɪtə ˈstrʌktʃə\(r\)/
data transfer rate	数据传输速率     /ˈdeɪtə trænsˈfɜː\(r\) reɪt/
data warehouse	数据仓库     /ˈdeɪtə weəhaʊs/
data window object	数据窗口对象     /ˈdeɪtə ˈwɪndəʊ ˈɒbdʒɪkt/
database	数据库     /ˈdeɪtəbeɪs/
database engine	数据库引擎     /ˈdeɪtəbeɪs ˈendʒɪn/
database interface	数据库接口     /ˈdeɪtəbeɪs ˈɪntəfeɪs/
database server	数据库服务器     /ˈdeɪtəbeɪs ˈsɜːvə\(r\)/
deadline	最终期限，截止日期     /ˈdedlaɪn/
deadlock	死锁     /ˈdedlɒk/
debit\-card	借记卡     
debugger	调试程序     /ˌdiːˈbʌɡə\(r\)/
decision tree	决策树     /dɪˈsɪʒn triː/
decoder	译码器，解码器     /ˌdiːˈkəʊdə\(r\)/
decryption	解密     
definition	定义     /ˌdefɪˈnɪʃn/
deformation	变形     /ˌdiːfɔːˈmeɪʃn/
demodulator	解调器     /ˌdiˌmɑdʒəˈleɪtər/
demographic	人口统计的     /ˌdeməˈɡræfɪk/
desktop	桌面     /ˈdesktɒp/
destination	目的地，目标文件     /ˌdestɪˈneɪʃn/
device contention	设备竞争     /dɪˈvaɪs kənˈtenʃn/
device dependent	设备相关的     /dɪˈvaɪs dɪˈpendənt/
device independent	设备无关的     /dɪˈvaɪs ˌɪndɪˈpendənt/
device object	设备对象     /dɪˈvaɪs ˈɒbdʒɪkt/
diagnosis	诊断     /ˌdaɪəɡˈnəʊsɪs/
diagram	图表     /ˈdaɪəɡræm/
dialog box	对话框     /ˈdaɪəlɒɡ bɒks/
digital camera	数码相机     /ˈdɪdʒɪtl ˈkæmərə/
digital cash	数字现金     /ˈdɪdʒɪtl kæʃ/
digital certificate	数字证书     /ˈdɪdʒɪtl səˈtɪfɪkət/
digital signature	数字签名     /ˌdɪdʒɪtl ˈsɪɡnətʃə\(r\)/
digital wallet	数字钱包     /ˈdɪdʒɪtl ˈwɒlɪt/
directory	目录     /dəˈrektəri/
discrete mathematics	离散数学     /dɪˈskriːt ˌmæθəˈmætɪks/
disk cleanup	磁盘清理     /dɪsk ˈkliːnʌp/
disk defragmenter	磁益碎片整理工具     
disk drive	磁盘驱动器     /ˈdɪsk draɪv/
diskette	软盘     /dɪsˈket/
diskless workstation	无盘工作站     
display adapter	显示适配器     /dɪˈspleɪ əˈdæptə/
dissertation	论文     /ˌdɪsəˈteɪʃn/
distributed database	分布式数据库     /dɪˈstrɪbjuːtɪd ˈdeɪtəbeɪs/
distributed processing	分布式处理     /dɪˈstrɪbjuːtɪd ˈprəʊsesɪŋ/
distributed system	分布式系统     /dɪˌstrɪbjuːtɪd ˈsɪstəm/
dot\-matrix	点阵     /dɒt ˈmeɪtrɪks/
downstream	向下传输     /ˌdaʊnˈstriːm/
drop\-down listbox	下拉式列表框     
drop\-down menu	下拉式菜单     /ˌdrɒp daʊn ˈmenjuː/
drum	硒鼓     /drʌm/
dynamic binding	动态绑定     /daɪˈnæmɪk ˈbaɪndɪŋ/
dynamic IP address	动态IP地址     /daɪˈnæmɪk ɪp əˈdres/
dynamic page	动态页面     /daɪˈnæmɪk peɪdʒ/
eavesdropping	窃听     /ˈiːvzdrɒpɪŋ/
edit	编辑     /ˈedɪt/
efficiency	有效性，效率     /ɪˈfɪʃnsi/
electronic banking	电子银行     /ɪˌlekˈtrɒnɪk ˈbæŋkɪŋ/
electronic cash	电子现金     /ɪˌlekˈtrɒnɪk kæʃ/
electronic check	电子支票     /ɪˌlekˈtrɒnɪk tʃek/
electronic commerce\(EC\)	电子商务     /ɪˌlekˈtrɒnɪk ˈkɒmɜːs/
electronic mail\(E\-mail\)	电子邮件     /ɪˌlektrɒnɪk ˈmeɪl/
electronic meeting	电子会议     /ɪˌlekˈtrɒnɪk ˈmiːtɪŋ/
electronic money	电子货币     /ɪˌlekˈtrɒnɪk ˈmʌni/
electronic payment	电子支付     /ɪˌlekˈtrɒnɪk ˈpeɪmənt/
electronic wallet	电子钱包     /ɪˌlekˈtrɒnɪk ˈwɒlɪt/
embedded computer	嵌入式计算机     /ɪmˈbedɪd kəmˈpjuːtə\(r\)/
embedded real\-time system	嵌入式实时系统     /ɪmˈbedɪd ˈriːəl taɪm ˈsɪstəm/
emoticon	表情符号     /ɪˈməʊtɪkɒn/
emulation	仿真     /ˌɛmjʊˈleɪʃən/
encapsulation	封装     
encode	编码     /ɪnˈkəʊd/
encryption	加密     /ɪnˈkrɪpʃ\(ə\)n/
encryption key	加密密钥     /ɪnˈkrɪpʃ\(ə\)n kiː/
end user	终端用户     /ˌend ˈjuːzə\(r\)/
enquiry	询问     /ɪnˈkwaɪəri/
entity	实体     /ˈentəti/
enumerate	枚举     /ɪˈnjuːməreɪt/
equivalent	相等的     /ɪˈkwɪvələnt/
erasure	消除     /ɪˈreɪʒə\(r\)/
etched circuit	蚀刻电路     /etʃt ˈsɜːkɪt/
etching technology	蚀刻技术     /ˈetʃɪŋ tekˈnɒlədʒi/
Ethernet	以太网     /ˈiːθənet/
evolution	演化     /ˌiːvəˈluːʃn/
exception	异常     /ɪkˈsepʃn/
expanded memory	扩充内存     /ɪkˈspændɪd ˈmeməri/
expansion slot	扩展插槽     /ɪkˈspænʃn slɒt/
expert system	专家系统     /ˌekspɜːt ˈsɪstəm/
expertise	专业知识     /ˌekspɜːˈtiːz/
exponential	指数的，幂的     /ˌekspəˈnenʃl/
extended attribute	扩展属性     /ɪkˈstendɪd əˈtrɪbjuːt/
extended memory	扩展内存     /ɪkˈstendɪd ˈmeməri/
extension	扩展名     /ɪkˈstenʃn/
facilitate	使方便，使     /fəˈsɪlɪteɪt/
facility	功能，工具     /fəˈsɪləti/
factor	因素     /ˈfæktə\(r\)/
fatal error	致命错误     /ˈfeɪtl ˈerə\(r\)/
fault tolerance	容错     /fɔːlt ˈtɒlərəns/
feasibility	可行性     /ˌfiːzəˈbɪlɪti/
feature	特征，特色     /ˈfiːtʃə\(r\)/
feedback	反馈     /ˈfiːdbæk/
fiber\-optic cable	光纤     /faɪbə ˈɒptɪk ˈkeɪbl/
field	字段（数据库的表）     /fiːld/
file handle	文件句柄     /faɪl ˈhændl/
file server	文件服务器     /faɪl ˈsɜːvə\(r\)/
file system	文件系统     /faɪl ˈsɪstəm/
filter	过滤器     /ˈfɪltə\(r\)/
fingerprint scanner	指纹扫描仪     /ˈfɪŋɡəprɪnt ˈskænə\(r\)/
firewall	防火墙     /ˈfaɪəwɔːl/
firmware	固件     /ˈfɜːmweə\(r\)/
flash memory	闪存     /ˈflæʃ meməri/
flexibility	弹性，适应性     /ˌfleksə'bɪləti/
floppy disk	软盘     /ˌflɒpi ˈdɪsk/
flow control	流量控制     /fləʊ kənˈtrəʊl/
flowchart	流程图，框图     /ˈfləʊtʃɑːt/
folder	文件夹     /ˈfəʊldə\(r\)/
font format	字体格式     /fɒnt ˈfɔːmæt/
foreground job	前台作业     /ˈfɔːɡraʊnd dʒəʊb/
foreign agent	外地代理     /ˈfɒrən ˈeɪdʒənt/
foreign key	外键     /ˈfɒrən kiː/
format	格式化     /ˈfɔːmæt/
fragmentation	碎片     /ˌfræɡmenˈteɪʃn/
front\-end	前端     /ˈfrʌnt end/
function key	功能键     /ˈfʌŋkʃn kiː/
game theory	博弈论     /ˈɡeɪm θɪəri/
gateway	网关     /ˈɡeɪtweɪ/
gigabit network	千兆网     /ˈɡɪɡəbɪt ˈnetwɜːk/
global scheduler	全局调度     
graphics package	图形包     /ˈɡræfɪks ˈpækɪdʒ/
graphics tablet	图形输入板     /ˈɡræfɪks tæblət/
grayscale	灰色     /ˈɡreɪskeɪl/
grid	格子，栅格     /ɡrɪd/
group editor	组编辑器     
groupware	组件     /ˈɡruːpweə\(r\)/
guarantee	保证     /ˌɡærənˈtiː/
guidance	向导，指导     /ˈɡaɪdns/
hacker	黑客     /ˈhækə\(r\)/
hanging indent	悬挂式缩进     /ˈhæŋɪŋ ɪnˈdent/
hardcopy	硬拷贝     
hashed file	散列文件     /hæʃt faɪl/
head node	头节点     /hed nəʊd/
head pointer	头指针     /hed ˈpɔɪntə\(r\)/
header and footer	页眉和页脚     /ˈhedə\(r\) ənd ˈfʊtə\(r\)/
headline	大字标题     /ˈhedlaɪn/
heap sort	堆排序     /hiːp sɔːt/
hexadecimal system	十六进制     /ˌheksəˈdesɪml ˈsɪstəm/
hierarchical directory structure	层次目录结构     /ˌhaɪəˈrɑːkɪkl dəˈrektəri ˈstrʌktʃə\(r\)/
high\-level language	高级语言     /haɪ ˈlevl ˈlæŋɡwɪdʒ/
histogram	柱状图     /ˈhɪstəɡræm/
home page	主页     /ˈhəʊm peɪdʒ/
host computer	主机     /həʊst kəmˈpjuːtə\(r\)/
hub	集线器     /hʌb/
Huffman codes	哈夫曼编码     /ˈhʌfmən koʊdz/
Huffman tree	哈夫曼树     /ˈhʌfmən triː/
hyperlink	超链接     /ˈhaɪpəlɪŋk/
hypertext	超文本     /ˈhaɪpətekst/
hypothetical	假设的，假定的     /ˌhaɪpəˈθetɪkl/
icon	图标     /ˈaɪkɒn/
image	图像     /ˈɪmɪdʒ/
image map	图像映射     /ˈɪmɪdʒ mæp/
immovable	固定的，不可移动的     /ɪˈmuːvəbl/
implementation	执行     /ˌɪmplɪmɛnˈteɪʃən/
index	索引     /ˈɪndeks/
individual	个人，个体     /ˌɪndɪˈvɪdʒuəl/
infection	传染     /ɪnˈfekʃn/
information superhighway	信息高速公路     /ˌɪnfəˈmeɪʃn ˌsuːpəˈhaɪweɪ/
inheritance	继承     /ɪnˈherɪtəns/
initialized	已初始化的     /ɪˈnɪʃəlaɪzd/
instruction	指令     /ɪnˈstrʌkʃn/
integrated package	集成软件包     /ˈɪntɪɡreɪtɪd ˈpækɪdʒ/
integration	整合     /ˌɪntɪˈɡreɪʃn/
integrity	完整性     /ɪnˈteɡrəti/
intelligent bridge	智能网桥     
intercept	拦截     /ˌɪntəˈsept/
interception	侦听     /ˌɪntə\(ː\)ˈsɛpʃən/
interface	接口，界面     /ˈɪntəfeɪs/
interlacing	隔行扫描的     /ˌɪntəˈleɪsɪŋ/
internal memory	内存储器     /ɪnˈtɜːnl ˈmeməri/
Internet	互联网     /ˈɪntənet/
Internet of things	物联网     /ˈɪntənet ɒv θɪŋz/
Internet telephone	网络电话     /ˈɪntənet ˈtelɪfəʊn/
interpreter	解释器，解释程序     /ɪnˈtɜːprətə\(r\)/
interrupt	中断     /ˌɪntəˈrʌpt/
interval	时间间隔     /ˈɪntəvl/
inkjet printer	喷墨打印机     /ˌɪŋkdʒet ˈprɪntə\(r\)/
intranet	内网     /ˈɪntrənet/
inventory	库存     /ˈɪnvəntri/
inversion	反转，倒置     /ɪnˈvɜːʃn/
IP address	网际协议地址     /ˌaɪ ˈpiː ədres/
iterative process	迭代过程     /ˈɪtərətɪv ˈprəʊses/
job object	作业对象     /dʒəʊb ˈɒbdʒɪkt/
job scheduler	作业调度程序     /dʒəʊb ˈʃɛdjuːlə/
joystick	操纵杆     /ˈdʒɔɪstɪk/
junk E\-mail	垃圾邮件     /dʒʌŋk iː meɪl/
jurisdiction	权限     /ˌdʒʊərɪsˈdɪkʃn/
justification	对齐     /ˌdʒʌstɪfɪˈkeɪʃn/
just\-in\-time manufacturing	即时生产     /dʒʌst ɪn taɪm ˌmænjuˈfæktʃərɪŋ/
kernel	核心，内核     /ˈkɜːnl/
keyboard	键盘     /ˈkiːbɔːd/
keyguard	键盘守卫     /kiː ɡɑːd/
keypad	辅助小键盘     /ˈkiːpæd/
keyword	关键字     /ˈkiːwɜːd/
kilobit	千比特，千位     /ˈkɪləbɪt/
kilobyte	千字节     /ˈkɪləbaɪt/
kit	套件     /kɪt/
label	标记，记号     /ˈleɪbl/
laser printer	激光打印机     /ˈleɪzə prɪntə\(r\)/
laser\-etched	激光蚀刻的     
layer	层     /ˈleɪə\(r\)/
layout	规划，布局     /ˈleɪaʊt/
leased line	专线     /liːst laɪn/
legitimacy	合法性，正统性     /lɪ'dʒɪtɪməsi/
letter quality	字符模式     /ˈletə\(r\) ˈkwɒləti/
library	库     /ˈlaɪbrəri/
life cycle	生命周期     /ˈlaɪf saɪkl/
light\-pen	光笔     /ˈlaɪt pen/
linear linked lists	线性链表     
linear lists	线性表     /ˈlɪniə\(r\) lɪsts/
link	链接     /lɪŋk/
linkage	连锁     /ˈlɪŋkɪdʒ/
linked radix sort	链式基数排序     
load	装载，装入     /ləʊd/
local scheduler	本地调度     
local variable	局部变量\.     /ˈləʊkl ˈveəriəbl/
location	定位，位置     /ləʊˈkeɪʃn/
log on	登录     /lɒɡ ɒn/
log out	注销     /lɒɡ aʊt/
logic circuit	逻辑电路     /ˈlɒdʒɪk sɜːkɪt/
logic complementation	逻辑补码法     
logical way	逻辑方式     
logical link control	逻辑链路控制     /ˈlɒdʒɪkl lɪŋk kənˈtrəʊl/
logical schema	逻辑架构     /ˈlɒdʒɪkl ˈskiːmə/
login	注册，登录     /ˈlɒɡɪn/
logistics	后勤，物流     /ləˈdʒɪstɪks/
low\-level language	低级语言     /ləʊ ˈlevl ˈlæŋɡwɪdʒ/
machine code	机器码     /məˈʃiːn kəʊd/
machine language	机器语言     /məˈʃiːn ˈlæŋɡwɪdʒ/
macro	宏     /ˈmækrəʊ/
magnetic pot	磁场     
magnetic tape	磁带     /mæɡˌnetɪk ˈteɪp/
magnification	扩大，放大率     /ˌmæɡnɪfɪˈkeɪʃn/
mail merging	邮件合并     /meɪl ˈmɜːdʒɪŋ/
mailbomb	邮件炸弹     
main memory	主存储器     /meɪn ˈmeməri/
main window	主窗口     /meɪn ˈwɪndəʊ/
mainframe	大型机，主机     /ˈmeɪnfreɪm/
maintain	维护     /meɪnˈteɪn/
maintenance	维持，维护     /ˈmeɪntənəns/
malignant	恶性的     /məˈlɪɡnənt/
manipulation	处理，操作     /məˌnɪpjʊˈleɪʃən/
manufacturer	制造者，厂商     /ˌmænjuˈfæktʃərə\(r\)/
masked edit	屏蔽编辑     /mɑːskt ˈedɪt/
match	匹配，相配     /mætʃ/
matrix	矩阵     /ˈmeɪtrɪks/
mechanism	机构，机制     /ˈmekənɪzəm/
media player	媒体播放器     /ˈmiːdiə ˈpleɪə\(r\)/
medium	媒介，媒体     /ˈmiːdiəm/
megabit	兆位，百万位     /ˈmeɡəbɪt/
megahertz	兆赫兹     /ˈmeɡəhɜːts/
memory card	内存卡     /ˈmeməri kɑːd/
memory stick	内存棒，记忆棒     /ˈmeməri stɪk/
menu bar	菜单栏     /ˈmenjuː bɑː\(r\)/
metadata	元数据     /ˈmetədeɪtə/
microphone	麦克风     /ˈmaɪkrəfəʊn/
microwave	微波，微波炉     /ˈmaɪkrəweɪv/
middleware	中间件     /ˈmɪdlweə\(r\)/
miniaturize	使小型化     /ˈmɪnətʃəraɪz/
minicomputer	小型计算机     /'mɪnikəmˌpjuːtə\(r\)/
mirror	镜像     /ˈmɪrə\(r\)/
mobile commerce	移动商务     /ˈməʊbaɪl ˈkɒmɜːs/
mobile marking	移动营销     
mobile phone	移动电话     /ˌməʊbaɪl ˈfəʊn/
modem	调制解调器     /ˈməʊdem/
monopoly	垄断，专利权     /məˈnɒpəli/
mother board	主板     /ˈmʌðə\(r\) bɔːd/
mount	装配，挂载     /maʊnt/
multicomputer	多计算机系统     
multidocument interface	多文档界面     
multiline edit box	多行编辑框     
multimedia	多媒体     /ˌmʌltiˈmiːdiə/
multiple inheritance	多重继承     /ˈmʌltɪpl ɪnˈherɪtəns/
multi\-processor	多处理器     /'mʌlti ˈprəʊsesə\(r\)/
multitasking	多任务     /ˌmʌltiˈtɑːskɪŋ/
multi\-threaded	多线程     /'mʌlti ˈθredɪd/
mutual exclusion	互斥     /ˈmjuːtʃuəl ɪkˈskluːʒn/
nanosecond	纳秒     /ˈnænəʊsekənd/
natural language	自然语言     /ˌnætʃrəl ˈlæŋɡwɪdʒ/
navigate	导航     /ˈnævɪɡeɪt/
netiquette	网络礼仪     /ˈnetɪkət/
network administer	网络管理员     
network layer	网络层     /ˈnetwɜːk ˈleɪə\(r\)/
network system	网络系统     /ˈnetwɜːk ˈsɪstəm/
neural networking	神经网络     /ˈnjʊərəl ˈnetwɜːkɪŋ/
newsgroups	新闻讨论组     /ˈnjuːzgruːps/
niche	商机     /niːʃ/
non\-blocking primitive	非阻塞原语     
non\-impact	无影响     /ˈnəʊn ˈɪmpækt/
nonrepudiation	不可抵赖性     
normalization	标准化，正常化     /ˌnɔːməlaɪˈzeɪʃən/
notation	表示法，符号，标志     /nəʊˈteɪʃn/
notepad	记事本     /ˈnəʊtpæd/
nozzle	喷嘴     /ˈnɒzl/
null string	空串     /nʌl strɪŋ/
Num Lock	数字键锁定     
numerical	数字的     /njuːˈmerɪkl/
object\-based system	基于对象的系统     
object\-oriented	面向对象     /ˈɒbdʒɪkt ɔːrientɪd/
object\-oriented system	面向对象系统     /ˈɒbdʒɪkt ˈɔːrientɪd ˈsɪstəm/
octal system	八进制系统     
offline	离线     /ˌɒfˈlaɪn/
online	在线     /ˌɒnˈlaɪn/
open system	开放系统     /ˈəʊpən ˈsɪstəm/
operand	操作数     /ˈɒpərænd/
operational	操作的     /ˌɒpəˈreɪʃənl/
optical disk	光盘     /ˈɒptɪkl dɪsk/
optical fiber cable	光导纤维电缆     /ˈɒptɪkl faɪbə ˈkeɪbl/
optimal scheduling algorithm	最优调度算法     
optimal tree	最优树     /ˈɒptɪməl triː/
optimization	最优化，最佳化     /ˌɒptɪmaɪˈzeɪʃn/
ordered tree	有序树     /ˈɔːdəd triː/
orthogonal list	十字链表     /ɔːˈθɒgənəl lɪst/
ouch\-sensitive display	触控式显示器     
out\-dated	过时的，逾期的     /aʊt ˈdeɪtɪd/
outline view	大纲视图     /ˈaʊtlaɪn vjuː/
output device	输出设备     /ˈaʊtpʊt dɪˈvaɪs/
outsourcing	外包     /ˈaʊtsɔːsɪŋ/
overflow	溢出     /ˌəʊvəˈfləʊ/
overfrequency	超频     
overlapped	重叠     /ˌəʊvəˈlæpt/
overloading	重载     /ˌəʊvəˈləʊdɪŋ/
package	软件包，组件     /ˈpækɪdʒ/
page description language	页面描述语言     /peɪdʒ dɪˈskrɪpʃn ˈlæŋɡwɪdʒ/
page fault	页故障     /peɪdʒ fɔːlt/
paradigm	范例     /ˈpærədaɪm/
parallel port	并行接口     /ˈpærəlel pɔːt/
password	口令，密码     /ˈpɑːswɜːd/
perform	执行     /pəˈfɔːm/
peripheral	外围设备     /pəˈrɪfərəl/
photo\-sensitive drum	感光鼓     
pie chart	饼图     /ˈpaɪ tʃɑːt/
pin printer	针式打印机     
pirate	盗版     /ˈpaɪrət/
plaintext	明文     
platform	平台     /ˈplætfɔːm/
plotter	绘图仪     /ˈplɒtə\(r\)/
pointing device	定位设备     /ˈpɔɪntɪŋ dɪvaɪs/
polling task	轮询任务     
polymorphism	多态性     /ˌpɒlɪˈmɔːfɪzm/
populate	填充     /ˈpɒpjuleɪt/
pop\-up menu	弹出式菜单     /pɒp ʌp ˈmenjuː/
pop\-up Window	弹出式窗口     /pɒp ʌp ˈwɪndəʊ/
portability	可移植性     /ˌpɔːtəˈbɪlɪti/
portable	便携式的     /ˈpɔːtəbl/
postulate	假设     /ˈpɒstjuleɪt/
precision transform	精确度变换     
preemptive multitasking	抢占式多任务     /priˈɛmptɪv ˌmʌltiˈtæskɪŋ/
Primary Key	主键     /ˈpraɪməri kiː/
printed circuit board	印刷电路板     /ˈprɪntɪd ˈsɜːkɪt bɔːd/
printer driver	打印机驱动程序     /ˈprɪntə\(r\) ˈdraɪvə\(r\)/
private cloud	私有云     /ˈpraɪvət klaʊd/
private key cryptography	私钥加密     /ˈpraɪvət kiː krɪpˈtɒɡrəfi/
privileged instruction	特权指令     /ˈprɪvəlɪdʒd ɪnˈstrʌkʃn/
procedural programming	面向过程程序设计     /prəˈsiːdʒərəl ˈprəʊɡræmɪŋ/
process	进程     /ˈprəʊses/
protocol	协议     /ˈprəʊtəkɒl/
prototype	原型     /ˈprəʊtətaɪp/
proxy server	代理服务器     /ˈprɒksi sɜːvə\(r\)/
public cloud	公有云     /ˈpʌblɪk klaʊd/
public key	公钥     /ˈpʌblɪk kiː/
public key cryptography	公钥加密     /ˈpʌblɪk kiː krɪpˈtɒɡrəfi/
pull technology	拉式技术     /pʊl tekˈnɒlədʒi/
push technology	推送技术     /ˈpʊʃ teknɒlədʒi/
quad speed	四倍速     
quadratic probing	二次探测     /kwɒˈdrætɪk ˈprəʊbɪŋ/
quantizer	数字转换器，编码器     
quantometer	光谱分析仪     
query	查询     /ˈkwɪəri/
queue	队列     /kjuː/
quit	退出     /kwɪt/
radio button	单选按钮     /ˈreɪdiəʊ bʌtn/
rationale	基本原理     /ˌræʃəˈnɑːl/
readiness	准备就绪     /ˈredinəs/
real time system	实时系统     /ˈriːəl taɪm ˈsɪstəm/
recipient	收件人     /rɪˈsɪpiənt/
recorder	记录机     /rɪˈkɔːdə\(r\)/
recursive function	递归函数     /rɪˈkɜːsɪv ˈfʌŋkʃn/
refresh	刷新     /rɪˈfreʃ/
refresh time	刷新率，更新率     /rɪˈfreʃ taɪm/
relational model	关系模型     /rɪˈleɪʃənl ˈmɒdl/
remark	注释，评论     /rɪˈmɑːk/
remote	远程     /rɪˈməʊt/
remote terminal	远程终端     /rɪˈməʊt ˈtɜːmɪnl/
removable	可移动的，可拆卸的     /rɪˈmuːvəbl/
replicate	复制     /ˈreplɪkeɪt/
reproduction	复制品，繁殖     /ˌriːprəˈdʌkʃn/
reset	复位，重置     /ˌriːˈset/
resident	驻留的     /ˈrezɪdənt/
resolution	分辨率     /ˌrezəˈluːʃn/
response window	响应式窗口     /rɪˈspɒns ˈwɪndəʊ/
restore	恢复     /rɪˈstɔː\(r\)/
retrieve	检索     /rɪˈtriːv/
revision	修改，修订     /rɪˈvɪʒn/
ribbon cartridge	色带盒，带状墨盒     /ˈrɪbən ˈkɑːtrɪdʒ/
right\-click	右击     /ˌraɪt ˈklɪk/
ring network	环形网络     /rɪŋ ˈnetwɜːk/
robotics	机器人技术     /rəʊˈbɒtɪks/
router	路由器     /ˈruːtə\(r\)/
routine	常规，例程     /ruːˈtiːn/
safe mode	安全模式     /ˈseɪf məʊd/
scalability	可伸展性     /skeɪləˈbɪlɪti/
scale	定标，缩放     /skeɪl/
scanner	扫描仪     /ˈskænə\(r\)/
screen saver	屏幕保护程序     /ˈskriːn seɪvə\(r\)/
script	脚本     /skrɪpt/
seamless	无缝连接的     /ˈsiːmləs/
search engine	搜索引擎     /ˈsɜːtʃ endʒɪn/
sector	扇区     /ˈsektə\(r\)/
security	安全     /sɪˈkjʊərəti/
security certificate	安全认证     /sɪˈkjʊərəti səˈtɪfɪkət/
segment	段     /ˈseɡmənt/
sensor	传感器     /ˈsensə\(r\)/
sequential	连续的     /sɪˈkwenʃl/
serial port	串行接口     /ˈsɪəriəl pɔːt/
server	服务器     /ˈsɜːvə\(r\)/
session	会话     /ˈseʃn/
shared variable	共享变量     /ʃeəd ˈveəriəbl/
short cut	短路     /ʃɔːt kʌt/
shortcut key	快捷键     /ˈʃɔːtkʌt kiː/
signature	签名     /ˈsɪɡnətʃə\(r\)/
simulator	仿真器，模拟器     /ˈsɪmjuleɪtə\(r\)/
simultaneous	同时发生的     /ˌsɪmlˈteɪniəs/
solid ink	固体油墨     /ˈsɒlɪd ɪŋk/
sound box	音箱     /saʊnd bɒks/
sound card	声卡     /ˈsaʊnd kɑːd/
source code	源代码     /ˈsɔːs kəʊd/
spam	垃圾邮件     /spæm/
span	跨越     /spæn/
spatiality	空间性     
speech generator	语音发生器     /spiːtʃ ˈdʒenəreɪtə\(r\)/
speech recognition	语音识别     /ˈspiːtʃ rekəɡnɪʃn/
speech synthesizer	语音合成器     /spiːtʃ ˈsɪnθəsaɪzə\(r\)/
spreadsheet	电子表格     /ˈspredʃiːt/
spyware	间谍软件     /ˈspaɪweə\(r\)/
stack	堆栈     /stæk/
stereo	立体音响，立体感觉的     /ˈsteriəʊ/
storage class specifier	存储类标识符     /ˈstɔːrɪdʒ klɑːs ˈspɛsɪfaɪə/
streaming audio	音频流     /ˈstriːmɪŋ ˈɔːdiəʊ/
streaming video	视频流     /ˈstriːmɪŋ ˈvɪdiəʊ/
streamline	流线型     /ˈstriːmlaɪn/
structure	结构体     /ˈstrʌktʃə\(r\)/
structure chart	结构图     /ˈstrʌktʃə\(r\) tʃɑːt/
subnet	子网     
subnet mask	子网掩码     
subroutine	子程序     /ˈsʌbruːtiːn/
supercomputer	超级计算机     /ˈsuːpəkəmpjuːtə\(r\)/
supplier	供应者，厂商     /səˈplaɪə\(r\)/
switch	交换机     /swɪtʃ/
symbolize	象征，用符号表现     /ˈsɪmbəlaɪz/
synchronous	同步的     /ˈsɪŋkrənəs/
syntax error	语法错误     /ˈsɪntæks ˈerə\(r\)/
synthesizer	综合者，合成器     /ˈsɪnθəsaɪzə\(r\)/
taskbar	任务栏     
technologist	技术专家     /tekˈnɒlədʒɪst/
technology	技术     /tekˈnɒlədʒi/
telecommunication	电子通信     /ˌtelikəˌmjuːnɪˈkeɪʃn/
telemarketing	电话销售     /ˈtelimɑːkɪtɪŋ/
telemetry	遥感勘测     /təˈlemətri/
telnet	远程登录程序     /ˈtelnet/
template file	模板文件     /ˈtempleɪt faɪl/
temporality	暂时，此时     
tender	投标     /ˈtendə\(r\)/
terminal	终端     /ˈtɜːmɪnl/
terminology	术语     /ˌtɜːmɪˈnɒlədʒi/
thermal printer	热敏打印机     /ˈθɜːml ˈprɪntə\(r\)/
thin client	瘦客户端     /θɪn ˈklaɪənt/
thread	线程     /θred/
three\-dimension	三维     /θriː daɪˈmenʃn/
throughput	吞吐量     /ˈθruːpʊt/
thumbnail	缩略图     /ˈθʌmneɪl/
time slicing	时间分片     /taɪm ˈslaɪsɪŋ/
time\-sharing	分时     /taɪm ˈʃeərɪŋ/
time\-varying	随时间变换的     /taɪm ˈveəriɪŋ/
title bar	标题栏     /ˈtaɪtl bɑː\(r\)/
toggle switch	拨动开关     /ˈtɒɡl swɪtʃ/
token	令牌，记号     /ˈtəʊkən/
toolkit	工具包     /ˈtuːlkɪt/
topology	拓扑结构     /tə'pɒlədʒɪ/
touchpad	触摸板     /ˈtʌtʃpæd/
trackball	轨迹球     /ˈtrækbɔːl/
transaction	事务，交易     /trænˈzækʃn/
transceiver	收发器     /trænˈsiːvə\(r\)/
translator	翻译     /trænzˈleɪtə\(r\)/
transparency	透明     /trænsˈpærənsi/
transport layer	传输层     /ˈtrænspɔːt ˈleɪə\(r\)/
typeface	字体     /ˈtaɪpfeɪs/
typeset	排版     
typewrite	打印机     
ubiquitous computing	普适计算     /juːˈbɪkwɪtəs kəmˈpjuːtɪŋ/
unambiguous	清楚的，明确的     /ˌʌnæmˈbɪɡjuəs/
unauthorized access	未授权访问     /ʌnˈɔːθəraɪzd ˈækses/
undirected graph	无向图     /ˌʌndɪˈrɛktɪd ɡræf/
union	共同体     /ˈjuːniən/
uni\-programming	单编程     
unleash	释放     /ʌnˈliːʃ/
unordered tree	无序树     /ˌʌnˈɔːdəd triː/
update	更新，修正     /ˌʌpˈdeɪt/
upgrade	升级     /ˌʌpˈɡreɪd/
upload	上传     /ˌʌpˈləʊd/
upstream rate	上行速率     /ˌʌpˈstriːm reɪt/
user account	用户账号     /ˈjuːzə\(r\) əˈkaʊnt/
user ID	用户标识符     /ˈjuːzə\(r\) ˌaɪ ˈdiː/
User Object	用户对象     /ˈjuːzə\(r\) ˈɒbdʒɪkt/
user\-defined	用户自定义     /ˈjuːzə\(r\) dɪˈfaɪnd/
utility	实用程序     /juːˈtɪləti/
utilize	利用     /ˈjuːtəlaɪz/
vacuum tube	真空管     /ˈvækjuːm tjuːb/
valid	有效的     /ˈvælɪd/
variable	变量     /ˈveəriəbl/
vector	矢量     /ˈvektə\(r\)/
vendor	供应商     /ˈvendə\(r\)/
versatile	通用的，万能的     /ˈvɜːsətaɪl/
version	版本     /ˈvɜːʃn/
vertical	垂直的     /ˈvɜːtɪkl/
video bandwidth	视频带宽     /ˈvɪdiəʊ ˈbændwɪdθ/
video capture card	视频采集卡     /ˈvɪdiəʊ ˈkæptʃə\(r\) kɑːd/
video clips	视频剪辑     /ˈvɪdiəʊ klɪps/
video conferencing	电视会议     /ˈvɪdiəʊ ˈkɒnfərənsɪŋ/
video display	显示器     /ˈvɪdiəʊ dɪˈspleɪ/
video phone	可视电话     /ˈvɪdiəʊ fəʊn/
virtual address space	虚拟地址空间     /ˈvɜːtʃuəl əˈdres speɪs/
virtual block caching	虚拟块高速缓存     /ˈvɜːtʃuəl blɒk ˈkæʃɪŋ/
virtual device	虚拟设备     /ˈvɜːtʃuəl dɪˈvaɪs/
Virtual Host Service	虚拟主机服务     
virtual interface	虚拟接口     /ˈvɜːtʃuəl ˈɪntəfeɪs/
virtual IP address	虚拟IP地址     /ˈvɜːrtʃuəl ɪp əˈdres/
virtual memory technology	虚拟存储器技术     /ˈvɜːtʃuəl ˈmeməri tekˈnɒlədʒi/
virus checker	病毒检査程序     /ˈvaɪrəs ˈtʃekə\(r\)/
visual arts	视觉艺术     /ˈvɪʒuəl ˈɑːts/
visualize	可视化     /ˈvɪʒuəlaɪz/
voice control	语音控制     /vɔɪs kənˈtrəʊl/
voice mail	语音邮件     /vɔɪs meɪl/
voice synthesis	语音合成     /vɔɪs ˈsɪnθəsɪs/
volatile	易失性的     /ˈvɒlətaɪl/
volume label	磁盘卷标     /ˈvɒljuːm ˈleɪbl/
warm boot	热启动     /wɔːm buːt/
wave form	波形     /weɪv fɔːm/
wave length	波长     /weɪv leŋθ/
Web page	网页     /web peɪdʒ/
Web paging	网页寻呼     /web ˈpeɪdʒɪŋ/
Web server	服务器     /web ˈsɜːvə\(r\)/
Web site	站点     /web saɪt/
wheel	特权用户     /wiːl/
wholesaler	批发商     /ˈhəʊlseɪlə\(r\)/
Wild Card Character	通配符     /waɪld kɑːd ˈkærəktə\(r\)/
Window Painter	窗口画板     /ˈwɪndəʊ ˈpeɪntə\(r\)/
Window\-based	基于视窗的     /ˈwɪndəʊ beɪst/
Windows	窗口     /ˈwɪndəʊz/
Windows message	窗口消息     /ˈwɪndəʊz ˈmesɪdʒ/
wire pirate	网盗     
wiretapping	搭线窃听     /ˈwaɪətæpɪŋ/
wizard	向导工具     /ˈwɪzəd/
word processor	文字处理软件     /ˈwɜːd prəʊsesə\(r\)/
workgroup hub	工作组集线器     
worksheet	工作表     /ˈwɜːkʃiːt/
workspace	工作区     /ˈwɜːkspeɪs/
workstation	工作站     /ˈwɜːksteɪʃn/
worm	蠕虫     /wɜːm/
worthless	无价值的,无益的     /ˈwɜːθləs/
wrap	隐臧,伪装     /ræp/
write protect	写保护     /ˌraɪt prəˈtekt/
xerography	静电印刷     
zero access	立即存取     /ˈzɪərəʊ ˈækses/
zero complement	补码     /ˈzɪərəʊ ˈkɒmplɪment/
zero suppression	消零     /ˈzɪərəʊ səˈpreʃn/
zone	区域     /zəʊn/
zoom	缩放     /zuːm/

abate	减轻，废除     /əˈbeɪt/
abstraction	抽象，摘要     /æbˈstrækʃn/
abuse	滥用     /əˈbjuːz/
accelerator	加速器     /əkˈseləreɪtə\(r\)/
accessible	易接近的     /əkˈsesəbl/
accountant	会计     /əˈkaʊntənt/
accurate	正确的     /ˈækjərət/
acronym	首字母缩略字     /ˈækrənɪm/
activate	激活     /ˈæktɪveɪt/
adequate	足够的     /ˈædɪkwət/
adjacent	领近的     /əˈdʒeɪsnt/
administrative	管理的     /ədˈmɪnɪstrətɪv/
affordable	负担得起     /əˈfɔːdəbl/
agency	代理机构     /ˈeɪdʒənsi/
align	匹配     /əˈlaɪn/
allot	分配     /əˈlɒt/
analogous	相似的     /əˈnæləɡəs/
analyst	分析家     /ˈænəlɪst/
annulus	环     /ˈanyələs/
anomalies	异常     /əˈnɒməliz/
anonymity	匿名     /ˌænəˈnɪməti/
anticipate	预料     /ænˈtɪsɪpeɪt/
apparently	清楚地     /əˈpærəntli/
appropriate	适当的     /əˈprəʊpriət/
arena	舞台     /əˈriːnə/
arithmetic	算术     /əˈrɪθmətɪk/
assembler	汇编程序     /əˈsemblə\(r\)/
assignment	分配     /əˈsaɪnmənt/
assortment	分类     /əˈsɔːtmənt/
attach	依附上     /əˈtætʃ/
attribute	属性     /əˈtrɪbjuːt/
audience	观众     /ˈɔːdiəns/
authentic	可信的     /ɔːˈθentɪk/
authentication	认证     /ɔːˌθentɪˈkeɪʃn/
available	可利用的，有效的     /əˈveɪləbl/
backbone	骨干     /ˈbækbəʊn/
bacterial	细菌的     /bækˈtɪəriəl/
behavior	行为     /bɪ'heɪvjə\(r\)/
billion	十亿     /ˈbɪljən/
bitmap	位图     /ˈbɪtmæp/
bluetooth	蓝牙     /'bluːˌtuːθ/
boost	促进     /buːst/
brute	暴力的     /bruːt/
budget	预算     /ˈbʌdʒɪt/
bureaucracy	官僚机构     /bjʊəˈrɒkrəsi/
calculator	计算器     /ˈkælkjuleɪtə\(r\)/
carburetor	化油器     /ˈkɑːbjʊrɛtə/
cellular	多孔的     /ˈseljələ\(r\)/
challenge	挑战     /ˈtʃælɪndʒ/
choke	窒息     /tʃəʊk/
churn	搅拌，制造     /tʃɜːn/
ciphertext	密文     /ˈsaɪfə\(r\) tekst/
coaxial	共轴的     /ˈkəʊˈæksɪəl/
cognitive	认识的     /ˈkɒɡnətɪv/
coherent	一致的     /kəʊˈhɪərənt/
combination	组合     /ˌkɒmbɪˈneɪʃn/
comfortable	舒服的     /ˈkʌmftəbl/
commodity	商品     /kəˈmɒdəti/
comparison	比较，对照     /kəmˈpærɪsn/
competitive	竞争的     /kəmˈpetətɪv/
comprehensive	有理解力的     /ˌkɒmprɪˈhensɪv/
conclusion	结论     /kənˈkluːʒn/
concurrently	同时发生地     /kənˈkʌrəntli/
configuration	结构     /kənˌfɪɡəˈreɪʃn/
confuse	使混乱     /kənˈfjuːz/
connectivity	连接     /ˌkɒnekˈtɪvəti/
consecutive	连续的     /kənˈsekjətɪv/
considerable	相当大的     /kənˈsɪdərəbl/
considerably	非常地     /kənˈsɪdərəbli/
consistency	一致     /kənˈsɪstənsi/
constraint	强制     /kənˈstreɪnt/
consultation	商议     /ˌkɒnslˈteɪʃn/
consumption	消费     /kənˈsʌmpʃn/
contractor	合同人     /kənˈtræktə\(r\)/
coordinate	使协调     /kəʊˈɔːdɪneɪt/
cordless	无绳的     /ˈkɔːdləs/
counteract	抵消     /ˌkaʊntərˈækt/
coverage	范围     /ˈkʌvərɪdʒ/
creativity	创造力     /ˌkriːeɪˈtɪvəti/
credibility	可靠的     /ˌkredəˈbɪləti/
criteria	标准     /kraɪ'tɪəriə/
critical	批评的     /ˈkrɪtɪkl/
crucial	关键的     /ˈkruːʃl/
cryptographic	加密的     /ˈkrɪptoʊ ˈɡræfɪk/
database	数据库     /ˈdeɪtəbeɪs/
deceptive	靠不住的     /dɪˈseptɪv/
decline	下降     /dɪˈklaɪn/
decode	译码     /ˌdiːˈkəʊd/
decompose	分解     /ˌdiːkəmˈpəʊz/
deficit	赤字     /ˈdefɪsɪt/
deflector	导向装置     /dɪˈflɛktə/
demodulation	解调     
denial	否认     /dɪˈnaɪəl/
denote	表示     /dɪˈnəʊt/
deploy	部署     /dɪˈplɔɪ/
deposit	保证金     /dɪˈpɒzɪt/
description	描述     /dɪˈskrɪpʃn/
diagnose	诊断     /ˈdaɪəɡnəʊz/
differentiate	区别     /ˌdɪfəˈrenʃieɪt/
disaster	灾害     /dɪˈzɑːstə\(r\)/
disburse	付出     /dɪsˈbɜːs/
disguise	伪装     /dɪsˈɡaɪz/
disposal	支配权     /dɪˈspəʊzl/
dispute	辩论     /dɪˈspjuːt/
dissect	仔细分析     /dɪˈsekt/
diverse	不同的     /daɪˈvɜːs/
domain	领域     /dəˈmeɪn/
dramatically	突然地     /drəˈmætɪk\(ə\)li/
drug	药物     /drʌɡ/
eavesdrop	偷听     /ˈiːvzdrɒp/
effortless	容易的     /ˈefətləs/
elevate	举起，提拔     /ˈelɪveɪt/
embedded	嵌入到     /ɪmˈbedɪd/
embody	使具体化     /ɪmˈbɒdi/
encapsulation	封装     
encompass	围绕     /ɪnˈkʌmpəs/
encounter	相遇     /ɪnˈkaʊntə\(r\)/
encryption	加密的     /ɪnˈkrɪpʃ\(ə\)n/
enhance	提高     /ɪnˈhɑːns/
enterprise	企业     /ˈentəpraɪz/
entrust	信托     /ɪnˈtrʌst/
epidemics	流行病     /ˌɛpɪˈdɛmɪks/
equivalent	相等的     /ɪˈkwɪvələnt/
erase	抹去     /ɪˈreɪz/
essential	本质的     /ɪˈsenʃl/
establish	建立     /ɪˈstæblɪʃ/
evaluate	评估     /ɪˈvæljueɪt/
executable	可执行的     /ɪɡˈzekjətəbl/
expenditure	支出，开销     /ɪkˈspendɪtʃə\(r\)/
exponentiation	幂运算     
extraction	提取     /ɪkˈstrækʃn/
extrapolate	推断     /ɪkˈstræpəleɪt/
facility	天赋     /fəˈsɪləti/
fashion	时尚     /ˈfæʃn/
feedback	反馈     /ˈfiːdbæk/
fleet	船队，车队     /fliːt/
flicker	闪烁     /ˈflɪkə\(r\)/
footnote	脚注     /ˈfʊtnəʊt/
forefront	前沿     /ˈfɔːfrʌnt/
formidable	艰难的     /fəˈmɪdəbl/
foster	培养     /ˈfɒstə\(r\)/
fraud	欺骗     /frɔːd/
funneled	倾销     /ˈfʌnld/
gateway	网关     /ˈɡeɪtweɪ/
gracefully	优美地     /ˈgreɪsfʊli/
granular	颗粒状的     /ˈɡrænjələ\(r\)/
guidance	指导     /ˈɡaɪdns/
handheld	手持     /ˈhændheld/
hazardous	危险地     /ˈhæzədəs/
headphone	耳机     /ˈhɛdfəʊn/
heap	堆     /hiːp/
heterogeneous	各种各样的     /ˌhetərəˈdʒiːniəs/
hierarchical	分层的     /ˌhaɪəˈrɑːkɪkl/
hierarchy	分层，等级     /ˈhaɪərɑːki/
hire	租用     /ˈhaɪə\(r\)/
horizontal axis	横轴     /ˌhɒrɪˈzɒntl ˈæksɪs/
hostile	敌对的     /ˈhɒstaɪl/
hybrid	混合的     /ˈhaɪbrɪd/
identical	完全一样的     /aɪˈdentɪkl/
illusion	幻想     /ɪˈluːʒn/
implicit	隐示的     /ɪmˈplɪsɪt/
inability	无能     /ˌɪnəˈbɪləti/
inbound	入境的     /ˈɪnbaʊnd/
inconsistency	不一致     /ˌɪnkənˈsɪstənsi/
indispensable	不可缺少的     /ˌɪndɪˈspensəbl/
infrastructure	基础设施     /ˈɪnfrəstrʌktʃə\(r\)/
ingredient	组成     /ɪnˈɡriːdiənt/
inheritance	继承     /ɪnˈherɪtəns/
initiate	开始     /ɪˈnɪʃieɪt/
injection	注入     /ɪnˈdʒekʃn/
ink jet printer	喷墨打印机     /ɪŋk dʒet ˈprɪntə\(r\)/
innovative	改革     /ˈɪnəveɪtɪv/
instantaneous	即时的     /ˌɪnstənˈteɪniəs/
insurance	保险     /ɪnˈʃʊərəns/
integral	整体的     /ˈɪntɪɡrəl/
interaction	交互作用     /ˌɪntərˈækʃən/
interference	干扰     /ˌɪntəˈfɪərəns/
interrogator	询问者     /ɪnˈtɛrəʊgeɪtə/
intervention	干预     /ˌɪntəˈvenʃn/
introspection	反省     /ˌɪntrəˈspekʃn/
intruder	侵入者     /ɪnˈtruːdə\(r\)/
invest	投资     /ɪnˈvest/
invoice	发票     /ˈɪnvɔɪs/
involvement	参与     /ɪnˈvɒlvmənt/
irrelevant	不相关的     /ɪˈreləvənt/
isolate	隔离     /ˈaɪsəleɪt/
kilobyte	千字节     /ˈkɪləbaɪt/
laptop	便携式计算机     /ˈlæptɒp/
leap	跳过     /liːp/
ledger	分类账簿     /ˈledʒə\(r\)/
license	许可证     /ˈlaɪsns/
logistics	物流，后勤     /ləˈdʒɪstɪks/
lossless	无损的     /ˈlɒsləs/
malicious	恶意的     /məˈlɪʃəs/
managerial	管理的     /ˌmænəˈdʒɪəriəl/
massive	宽大的，宏伟的     /ˈmæsɪv/
mastery	精通     /ˈmɑːstəri/
maturity	成熟     /məˈtʃʊərəti/
mechanism	机制，方法     /ˈmekənɪzəm/
megabyte	兆字节     /ˈmeɡəbaɪt/
megahertz	兆赫兹     /ˈmeɡəhɜːts/
merchandise	商品     /ˈmɜːtʃəndaɪz/
merge	使合并     /mɜːdʒ/
metropolitan	大城市的     /ˌmetrəˈpɒlɪtən/
microphone	麦克风     /ˈmaɪkrəfəʊn/
middleware	中间件     /ˈmɪdlweə\(r\)/
mimic	模仿     /ˈmɪmɪk/
modifiable	可修改的     /ˈmɒdɪfaɪəbl/
modular	模块化的     /ˈmɒdjələ\(r\)/
modulation	调制，缓和     /ˌmɒdjʊˈleɪʃən/
monetary	货币的     /ˈmʌnɪtri/
monochrome	单色的，黑白的     /ˈmɒnəkrəʊm/
monolithic	整体的     /ˌmɒnəˈlɪθɪk/
morph	变种     /mɔːf/
multidimensional	多维的     /ˌmʌltɪdɪˈmɛnʃənl/
needle	针     /ˈniːdl/
negotiation	谈判     /nɪˌɡəʊʃiˈeɪʃn/
neighbor	邻居     /'neɪbə\(r\)/
nickname	绰号     /ˈnɪkneɪm/
notation	符号，记号     /nəʊˈteɪʃn/
nozzle	喷嘴     /ˈnɒzl/
obedient	服从的     /əˈbiːdiənt/
observation	观察     /ˌɒbzəˈveɪʃn/
obsolescence	淘汰     /ˌɒbsəˈlesns/
obstacle	障碍     /ˈɒbstəkl/
occupy	占领     /ˈɒkjupaɪ/
ontology	本体论     /ɒnˈtɒlədʒi/
operand	操作数     /ˈɒpərænd/
orthogonal	垂直的     /ɔːˈθɒgənəl/
outbound	出境的     /ˈaʊtbaʊnd/
outcome	结果     /ˈaʊtkʌm/
out\-of\-date	过时的     /ˌaʊt əv ˈdeɪt/
overlap	重叠     /ˌəʊvəˈlæp/
overt	公开的     /əʊˈvɜːt/
overwhelming	压倒性的     /ˌəʊvəˈwelmɪŋ/
partition	分割     /pɑːˈtɪʃn/
pattern	模式     /ˈpætn/
payment	付款     /ˈpeɪmənt/
payroll	工资表     /ˈpeɪrəʊl/
penetrate	渗透     /ˈpenətreɪt/
perceive	感知，领悟     /pəˈsiːv/
perceptible	可察觉的     /pəˈseptəbl/
perform	执行     /pəˈfɔːm/
performance	表现，性能     /pəˈfɔːməns/
periodically	周期性地     /ˌpɪərɪˈɒdɪkəli/
permeation	渗透     
permission	许可     /pəˈmɪʃn/
pertinent	恰当的     /ˈpɜːtɪnənt/
phenomenon	现象     /fəˈnɒmɪnən/
philosophy	哲学     /fəˈlɒsəfi/
pillar	台柱     /ˈpɪlə\(r\)/
pixel	像素     /ˈpɪksl/
plaintext	明文     
polymorphism	多态性     /ˌpɒlɪˈmɔːfɪzm/
portable	手提的     /ˈpɔːtəbl/
powder	粉     /ˈpaʊdə\(r\)/
preconceive	事先认为     /ˌpriːkənˈsiːv/
prediction	预言     /prɪˈdɪkʃn/
prescribe	命令     /prɪˈskraɪb/
prevailing	优势的，普遍的     /prɪˈveɪlɪŋ/
primitive	原始的，基础的     /ˈprɪmətɪv/
priority	优先     /praɪˈɒrəti/
privilege	特权     /ˈprɪvəlɪdʒ/
problematic	疑难的     /ˌprɒbləˈmætɪk/
procure	获得     /prəˈkjʊə\(r\)/
profession	职业     /prəˈfeʃn/
profit	利润     /ˈprɒfɪt/
progress	进展     /ˈprəʊɡres/
prohibitive	禁止地     /prəˈhɪbətɪv/
proliferate	扩散     /prəˈlɪfəreɪt/
property	性质，财产     /ˈprɒpəti/
proportional	成比例的     /prəˈpɔːʃənl/
psychology	心理学     /saɪˈkɒlədʒi/
purchase	购买     /ˈpɜːtʃəs/
pursue	追求     /pəˈsjuː/
pursuit	追踪     /pəˈsjuːt/
quotation	引用，引文     /kwəʊˈteɪʃn/
quote	报价，引用     /kwəʊt/
rack	支架     /ræk/
rationality	合理性     /ˌræʃə'nælətɪ/
reallocated	再分配     /ˌriːˈæləkeɪtɪd/
recipe	食谱     /ˈresəpi/
recognition	识别     /ˌrekəɡˈnɪʃn/
reference	参考，索引     /ˈrefrəns/
reflect	反映，表达     /rɪˈflekt/
register	寄存器     /ˈredʒɪstə\(r\)/
regular	常规的     /ˈreɡjələ\(r\)/
relevance	重要性     /ˈreləvəns/
remarkable	显著的     /rɪˈmɑːkəbl/
remedy	修补，纠正     /ˈremədi/
repairperson	维修人员     
represent	表示，代表     /ˌreprɪˈzent/
representative	典型的     /ˌreprɪˈzentətɪv/
resemble	相似     /rɪˈzembl/
resolution	分辨率     /ˌrezəˈluːʃn/
restrict	限制     /rɪˈstrɪkt/
resume	概述     /rɪˈzjuːm/
retrieve	检索，恢复     /rɪˈtriːv/
reusability	可重用性     
reused	重复使用     /ˌriːˈjuːzd/
revive	复苏     /rɪˈvaɪv/
roam	漫游     /rəʊm/
roughly	粗略地     /ˈrʌfli/
router	路由器     /ˈruːtə\(r\)/
savvy	精明的     /ˈsævi/
schema	模式，纲要     /ˈskiːmə/
scratch	凑合的     /skrætʃ/
seamless	无缝的     /ˈsiːmləs/
seemingly	外观上地     /ˈsiːmɪŋli/
segmentation	分割     /ˌseɡmenˈteɪʃn/
separation	分离     /ˌsepəˈreɪʃn/
session	期间，会议     /ˈseʃn/
shielding	屏蔽     /ˈʃiːldɪŋ/
significance	意义，重要性     /sɪɡˈnɪfɪkəns/
simplicity	简单     /sɪmˈplɪsəti/
simplistic	过分简单化的     /sɪmˈplɪstɪk/
sophisticated	复杂的     /səˈfɪstɪkeɪtɪd/
specification	规格，说明     /ˌspesɪfɪˈkeɪʃn/
spray	喷洒     /spreɪ/
spreadsheet	电子表格     /ˈspredʃiːt/
stakeholder	利益共享者     /ˈsteɪkhəʊldə\(r\)/
statistic	统计学的     /stəˈtɪstɪk/
stick	粘，坚持     /stɪk/
strategic	战略性的     /strəˈtiːdʒɪk/
subclass	子类     
submit	提交     /səbˈmɪt/
subroutine	子程序     /ˈsʌbruːtiːn/
superfluous	多余的，过剩的     /suːˈpɜːfluəs/
supervise	监督，指导     /ˈsuːpəvaɪz/
surgeon	外科医生     /ˈsɜːdʒən/
suspend	暂停     /səˈspend/
sustain	维持     /səˈsteɪn/
synthesis	合成     /ˈsɪnθəsɪs/
telecommunication	电信     /ˌtelikəˌmjuːnɪˈkeɪʃn/
temporary	临时     /ˈtemprəri/
tendency	趋势     /ˈtendənsi/
tender	温柔的     /ˈtendə\(r\)/
terminate	结束     /ˈtɜːmɪneɪt/
terseness	简洁     
threat	威胁     /θret/
token	令牌     /ˈtəʊkən/
topology	拓扑结构     /tə'pɒlədʒɪ/
transact	办理     /trænˈzækt/
transaction	事务     /trænˈzækʃn/
transparent	显而易见的     /trænsˈpærənt/
trillion	万亿，兆     /ˈtrɪljən/
troubleshoot	排除故障     /ˈtrʌblʃuːt/
trust	信任     /trʌst/
turbocharger	涡轮增压器     /ˈtɜːbəʊtʃɑːdʒə\(r\)/
turn off	关闭     /ˈtɜːn ɒf/
tutorial	教程     /tjuːˈtɔːriəl/
twitter	推特     /ˈtwɪtə\(r\)/
ubiquitous	普遍存在的     /juːˈbɪkwɪtəs/
ubiquity	随处可见     /juːˈbɪkwəti/
uncountable	无数的     /ʌnˈkaʊntəbl/
undergo	经历     /ˌʌndəˈɡəʊ/
uniformity	一致     /ˌjuːnɪˈfɔːməti/
uniquely	唯一地     /juː'niːkli/
unpredictable	不可预知的     /ˌʌnprɪˈdɪktəbl/
unreliable	不可靠的     /ˌʌnrɪˈlaɪəbl/
unsurpassed	出类拔萃的     /ˌʌnsəˈpɑːst/
upgrade	升级     /ˌʌpˈɡreɪd/
utilization	利用     /ˌjuːtəlaɪˈzeɪʃn/
utmost	极度的     /ˈʌtməʊst/
vacuum	真空     /ˈvækjuːm/
vertical axis	纵轴     /ˈvɜːtɪkl ˈæksɪs/
violation	违反     /ˌvaɪə'leɪʃ\(ə\)n/
voluminous	大的     /vəˈluːmɪnəs/
vulnerability	弱点     /ˌvʌlnərə'bɪlətɪ/
warehouse	仓库     /ˈweəhaʊs/
wavelength	波长     /ˈweɪvleŋθ/
whereas	然而     /ˌweərˈæz/
wireless	无线的     /ˈwaɪələs/
zero stock	零库存     /ˈzɪərəʊ stɒk/

